11111111111111
100000000000K1
100K0000P00001
10C00000000001
100000111000C1
10000010000011
100000100000K1
11111111111111
