11111111111111
1P0KK000000001
1E000CCCC00001
10000011100001
10000010000011
10000010000001
11111111111111
