11111111111111
100000000000K1
100K0000P00001
10CCC000000001
10000011100001
1000001000E011
100000100000K1
11111111111111
