111111111111111111111
1000P0010000000000001
1000001E1000000000001
10000001CC00000000001
10K00000CC10000000001
111111111111111111111